# C # C C C C W C C C # % C C C C C C @
P C C C C # C C C C C # C # C C C C C C
& # % @ C C # C % C % C C # % C C C C C
C C @ % C C W J C C & C C C C C C C C C
# C # C C # C C # # C C # C C C @ # C %
C C C P C C C C @ C C C C C C @ C C C @
C J C $ # C C C C $ C # * C C $ # C C C
C C C C C C C C C C C J C C # C C C C C
C # P C W P C # # C C C # C C C C C C C
C C C C C C # # # C C P C % C C @ C C C
C C C C C C & C C C # J C # C C @ C C C
C C C C C C C C C C C C C C C # J C C J
C C C C # C P # C C C C C # C C # C C C
C C C C C C C C C C P C C C % % C J C C
C C J C C C C # W C # C C C $ C C & C C
# C & C W C C C C % C C C C # C C C C C
C C C C C % C C C C C C C # # # % C # C
# % C C C C C % C # C C # W C # C C C C
P C C C C C C # C C C C C $ C C C C # C
# C C C C C C J P C C C $ C C # C C P C
