P P C J W # C # C C C @ C C % C % C C C
# C C C C C C C # C C C C # C C C C C J
# C C # C C C $ C P C % C C C C C P C C
C C C # C % C C W C # & # C P C C C C #
C P C % # C # C C # # * C C C W J C C C
C $ C C C C @ C C C C C C C C C C C # C
C # C C C # C C C C C C C C C % C C C C
& # C # # C C C J # C C C C C C # C C C
C C # C C C % C C C & C C C C C C & C C
C W # C C C C C C C C C C C C C C C C C
C C C C P C C C C C P C C C C C C C # C
C C C C @ C C C C C C C C # C C C C C %
C C C C C & W C C # # C C W C # C $ $ C
C C C C C C C # # C C C % C J C C % C C
@ C # C $ # # C C C C C C C C C C C & W
# C C C C C C C W C C C C C & C C C C C
C C # C % C # C C P C # C C C C C C J C
P C C # # C C C C % % C C C @ C C # C C
# C @ C C C C C # C C % C C # # # C C P
C C C C C # % C C C C $ C C C C C @ # #
